(no author) = cvs2svn <no_author@no_author>
root = root <no_author@no_author>

agloess = Andreas Glöß <andreas.gloess@gmx.de>
alazzaro = Alfio Lazzaro <alfio.lazzaro@chem.uzh.ch>
akohlmey = Axel Kohlmeyer <axel.kohlmeyer@temple.edu>
aps = Ari Paavo Seitsonen <apsi@iki.fi>
ceriottm = Michele Ceriotti <michele.ceriotti@epfl.ch>
cjmundy = Chris Mundy <chris.mundy@pnnl.gov>
delben = Mauro Del Ben <mauro.delben@chem.uzh.ch>
dorotheagolze = Dorothea Golze <dorothea.golze@chem.uzh.ch>
fawzi = Mohamed Fawzi <fawzi@cp2k.org>
fschiff = Florian Schiffmann <florian.schiffmann@mat.ethz.ch>
gtb = Gloria Tabacchi <gloria.tabacchi@uninsubria.it>
hbani = Hossein Banihashemian <hossein.banihashemian@mat.ethz.ch>
hforbert = Harald Forbert <harald.forbert@theochem.ruhr-uni-bochum.de>
ibethune = Iain Bethune <iain.bethune@stfc.ac.uk>
ikuo = I-Feng William Kuo <kuo2@llnl.gov>
janwilhelm = Jan Wilhelm <jan.wilhelm@chem.uzh.ch>
jgh = Jürg Hutter <juerg.hutter@chem.uzh.ch>
jhutter = Jürg Hutter <juerg.hutter@chem.uzh.ch>
krack = Matthias Krack <matthias.krack@psi.ch>
lwalewski = Lukasz Walewski <lwalewski@cp2k.org>
mandes = Mandes Schönherr <m.schoenherr@pci.uzh.ch>
marcella = Marcella Iannuzzi <marcella.iannuzzi@chem.uzh.ch>
marci73 = Marcella Iannuzzi <marcella.iannuzzi@chem.uzh.ch>
mcgrath = Matthew McGrath <mcgrath@cp2k.org>
mguidon = Manuel Guidon <mguidon@cp2k.org>
mkrack = Matthias Krack <matthias.krack@psi.ch>
mmcgrath = Matthew McGrath <mcgrath@cp2k.org>
mmcgrathcp2k = Matthew McGrath <mcgrath@cp2k.org>
nholmber = Holmberg Nico <nico.holmberg@aalto.fi>
oschuett = Ole Schütt <ole.schuett@cp2k.org>
pousa = Christian Pousa <pousa@cp2k.org>
pseewald = Patrick Seewald <patrick.seewald@chem.uzh.ch>
rybkinjr = Vladimir Rybkin <rybkinjr@gmail.com>
sandermatt = Samuel Andermatt <samuel.andermatt@mat.ethz.ch>
schulkov = Sergey Chulkov <schulkov@lincoln.ac.uk>
tchassai = Thomas Chassaing <tchassai@cp2k.org>
tizianomueller = Tiziano Müller <tiziano.mueller@chem.uzh.ch>
tkuehne = Thomas D. Kühne <tdkuehne@mail.upb.de>
tlaino = Teodoro Laino <teodoro.laino@gmail.com>
tonglianheng = Tong Lianheng <k1338545@kcl.ac.uk>
uborstnik = Urban Borštnik <urban.borstnik@id.ethz.ch>
urban = Urban Borštnik <urban.borstnik@id.ethz.ch>
vondele = Joost VandeVondele <joost.vandevondele@cscs.ch>
vweber = Valery Weber <vwe@zurich.ibm.com>
